####################
#P...N....H........#
#........####.S.S..#
#...##....##.......#
#...##...S.........#
#..........####....#
#....##....#C.#....#
#.C..##....#.......#
#....H.....####.S..#
#..######..........#
#..#C.S.#...####...#
#..#W...#...#C.#...#
#..##.###...##.#...#
#....W.......S.....#
####################
